program = otherFunctions mainFunction
mainFunction = TK_MAIN stmts TK_END
otherFunctions = function otherFunctions | ∈
function = TK_FUNID input_par output_par TK_SEM stmts TK_END
input_par = TK_INPUT TK_PARAMETER TK_LIST TK_SQL parameter_list TK_SQR
output_par = TK_OUTPUT TK_PARAMETER TK_LIST TK_SQL parameter_list TK_SQR| ∈
parameter_list = dataType TK_ID remaining_list
dataType = primitiveDatatype | constructedDatatype
primitiveDatatype = TK_INT | TK_REAL
constructedDatatype = TK_RECORD TK_RUID | TK_UNION TK_RUID | TK_RUID
remaining_list = TK_COMMA parameter_list | ∈
stmts = typeDefinitions declarations otherStmts returnStmt
typeDefinitions = typeDefinition typeDefinitions | definetypestmt typeDefinitions | ∈
typeDefinition = TK_RECORD TK_RUID fieldDefinitions TK_ENDRECORD
typeDefinition =TK_UNION TK_RUID fieldDefinitions TK_ENDUNION
fieldDefinitions = fieldDefinitionfieldDefinitionmoreFields
fieldDefinition = TK_TYPE dataType TK_COLON TK_FIELDID TK_SEM
moreFields = fieldDefinitionmoreFields | ∈
declarations = declarationdeclarations | ∈
declaration = TK_TYPE dataType TK_COLON TK_ID global_or_not
TK_SEM
global_or_not = TK_COLON TK_GLOBAL | ∈
otherStmts = stmt otherStmts | ∈
stmt = assignmentStmt | iterativeStmt | conditionalStmt | ioStmt funCallStmt
assignmentStmt = SingleOrRecId TK_ASSIGNOP arithmeticExpression TK_SEM
singleOrRecId =TK_ID B 
B = TK_DOT TK_FIELDID B | ∈
funCallStmt = outputParameters TK_CALL TK_FUNID TK_WITH TK_PARAMETERS inputParameters TK_SEM
outputParameters = TK_SQL idList TK_SQR TK_ASSIGNOP | ∈
inputParameters = TK_SQL idList TK_SQR
iterativeStmt = TK_WHILE TK_OP booleanExpression TK_CL stmt otherStmts TK_ENDWHILE
conditionalStmt = TK_IF TK_OP booleanExpression TK_CL TK_THEN stmt otherStmts else TK_ENDIF
else = TK_ELSE otherStmts | ∈
ioStmt =TK_READ TK_OP var TK_CL TK_SEM | TK_WRITE TK_OP var TK_CL TK_SEM
arithmeticExpression = addORsub
addORsub = mulORdiv ADDSUB addORsub | mulORdiv
mulORdiv = brackets MULDIV mulORdiv | brackets
brackets = TK_OP arithmeticExpression TK_CL | var
MULDIV = TK_MUL | TK_DIV
ADDSUB = TK_PLUS | TK_MINUS
booleanExpression = TK_OP booleanExpression TK_CL logicalOp TK_OP
booleanExpression TK_CL
booleanExpression = var relationalOp var
booleanExpression = TK_NOT TK_OP booleanExpression TK_CL
var = singleOrRecId | TK_NUM | TK_RNUM
logicalOp = TK_AND | TK_OR
relationalOp = TK_LT | TK_LE | TK_EQ |TK_GT | TK_GE | TK_NE
returnStmt = TK_RETURN optionalReturn TK_SEM
optionalReturn = TK_SQL idList TK_SQR | ∈
idList = TK_ID more_ids
more_ids = TK_COMMA idList | ∈
definetypestmt = TK_DEFINETYPE A TK_RUID TK_AS TK_RUID
A = TK_RECORD | TK_UNION